24 40
#######################################
#.....................................#
#.###.###.###.###.###.###.###.###.###.#
#.###.###.###.###.###.###.###.###.###.#
#.###.###.###.###.###.###.###.###.###.#
#.....................................#
#.###.###.###.###.###.###.###.###.###.#
#.###.###.###.###.###.###.###.###.###.#
#.###.###.###.###.###.###.###.###.###.#
#.....................................#
#.###.###.###.###########.###.###.###.#
#.###.###.###.#         #.###.###.###.#
#.###.###.###.#         #.###.###.###.#
#.###.###.###.###########.###.###.###.#
#.....................................#
#.###.###.###.###.###.###.###.###.###.#
#.###.###.###.###.###.###.###.###.###.#
#.###.###.###.###.###.###.###.###.###.#
#.....................................#
#.###.###.###.###.###.###.###.###.###.#
#.###.###.###.###.###.###.###.###.###.#
#.###.###.###.###.###.###.###.###.###.#
#.....................................#
#######################################